###################
#Oooooooo#oooooooO#
#o##o###o#o###o##o#
#ooooooooooooooooo#
#o##o#o#####o#o##o#
#oooo#ooo#ooo#oooo#
####o###o#o###o####
####o#ooo ooo#o####
####o#o##D##o#o####
ooooooo#   #ooooooo
####o#o#####o#o####
####o#ooo ooo#o####
####o#o#####o#o####
#oooooooo#oooooooo#
#o##o###o#o###o##o#
#oo#ooooooooooo#oo#
##o#o#o#####o#o#o##
#oooo#ooo#ooo#oooo#
#o######o#o######o#
#OoooooooooooooooO#
###################