######################
#                    #
#              ###   #
#                    #
#   ###              #
#                    #
#                    #
#                    #
#                    #
#                    #
#                    #
#                    #
#                    #
#                    #
#                    #
#   #                #
#   #                #
#   #                #
#   ###              #
#                    #
#                    #
#                    #
######################